---##############################################################################################---
---#--------------------------------------------------------------------------------------------#---
---#--------@------$----------------------------------------------------------------------------#---
---#--------------------------------------------------------------------------------------------#---
---#--------------------------------------------------------------------------------------------#---
---###########----------############################################################------------#---
-------------#----------#----------------------------------------------------------#------------#---
-------------#----------#----------------------------------------------------------#------------#---
-------------#----------#----------------------------------------------------------#------------#---
-------------#----------#----------------------------------------------------------#------------#---
-------------#----------#----------------------------------------------------------#------------#---
-------------#----------#----------------------------------------------------------#------------#---
-------------#----------#----------------------------------------------------------#------------#---
-------------#----------#----------------------------------------------------------#------------#---
---------#####----------#-------------------########################################------------#---
---------#----------####-----------------####------------------------------------------------####---
---------#----------#-------------------#---------------------------------------------------#-------
---------#----------#-------------------#---------------------------------------------------#-------
---------#----------#-------------------#---------------------------------------------------#-------
---------#-----X----#-------------------#---------------------------------------------------#-------
---------#----------#-------------------#---------------------------------------------------#-------
---------#----------#-------------------#---------------------------------------------------#-------
---------#----------#-------------------#----------#############################------------#-------
---------#----------#####---------------#----------#---------------------------#------------#####---
---------#####----------#---------------#####------#####-----------------------#####------------####
-------------#----------#-------------------#----------#---------------------------#------------####
-------------#----------#####################----------#---------------------------#------------####
-------------#-----------------------------------------#---------------------------#------------####
-------------#-----------------------------------------#---------------------------#------------####
-------------#-----------------------------------------#---------------------------#------------####
-------------#-----------------------------------------#---------------------------#------------####
-------------#-----------------------------------------#---------------------------#------------####
-------------#-----------------------------------------#---------------------------#------------####
-------------#-----------------------------------------#############################------------####
-------------#----------------------------------------------------------------------------------####
-------------#----------------------------------------------------------------------------------####
-------------#----------------------------------------------------------------------------------####
-------------#----------------------------------------------------------------------------------####
-------------#----------------------------------------------------------------------------------####
-------------#----------------------------------------------------------------------------------####
-------------#----------------------------------------------------------------------------------####
-------------#----------------------------------------------------------------------------------####
-------------#----------------------------------------------------------------------------------####
####################################################################################################
####################################################################################################
####################################################################################################
####################################################################################################
####################################################################################################
####################################################################################################
####################################################################################################